1111111111111111111111111111111111
100000000000000C00000C000000000001
1010010100100000101001000000010111
10100100101010100010010000000101P1
1E1000000C00C000000000000000000001
1111111111111111111111111111111111